8 13 17 0
6,11,15,1
7,11,15,1
8,10,15,1
9,10,15,1
10,9,15,1
11,9,15,1
12,12,17,1
13,12,17,1
14,11,17,1
15,11,15,1
16,11,13,1
tele
11,11,9,11
12,14,11,12
12,12,14,13