9 9 13 0
8,12,15,1
9,9,17,1
10,9,12,1
10,13,17,1
11,9,17,1
12,10,17,1
13,10,15,1
14,13,15,1