9 12 19 2
7,10,14,1
8,10,14,1
9,9,15,1
10,7,17,1
11,7,17,1
12,9,15,1
13,8,16,1
14,8,11,1
14,13,16,1
15,10,11,1
15,13,14,1
16,10,14,1
tele
16,12,16,11
10,14,10,9
10,13,10,10
13,9,13,14
12,11,12,12