11 11 19 1
8,9,16,1
9,8,12,1
9,13,16,1
10,8,9,1
10,10,18,1
11,8,18,1
12,9,18,1
13,9,16,1
13,17,18,1
14,11,18,1
15,13,15,1
tele
12,13,11,17