14 10 11 0
10,12,14,1
11,12,14,1
12,12,16,1
13,10,16,1
14,10,11,1
14,13,18,1
15,10,18,1
16,10,12,1
16,15,17,1
17,15,17,1