11 11 10 1
8,10,14,1
9,8,14,1
10,8,14,1
11,8,15,1
12,8,15,1
13,11,13,1
tele
13,12,10,13