10 16 24 0
7,13,15,1
7,17,19,1
8,13,19,1
9,13,19,1
10,13,15,1
10,16,21,1
11,10,21,1
12,10,21,1
13,10,16,1
13,17,21,1
14,10,21,1
15,14,21,1