8 8 13 1
8,8,14,1
9,8,12,1
9,13,15,1
10,8,15,1
11,8,15,1
12,8,15,1
13,9,10,1
13,11,15,1
14,9,12,1
tele
12,10,12,13