9 10 5 0
9,10,11,1
10,10,14,1
11,9,12,1
11,13,14,1
12,9,10,1
12,11,14,1
13,9,12,1