11 11 10 0
8,11,13,1
9,10,15,1
9,11,12,2
10,10,15,1
11,10,16,1
12,10,16,1
12,12,13,2
13,10,13,1
13,14,16,1