11 14 15 0
10,11,16,1
11,11,16,1
12,10,17,1
13,10,17,1
14,10,18,1
15,12,18,1
16,12,16,1
17,12,16,1