10 13 15 2
7,11,15,1
8,11,15,1
9,9,15,1
10,9,10,1
10,11,15,1
11,8,16,1
12,8,14,1
12,15,16,1
13,8,10,1
13,11,16,1
14,8,15,1
tele
13,13,8,11
9,12,10,11
13,8,13,9
12,11,7,11