11 11 9 0
9,11,13,1
10,7,13,1
11,7,13,1
12,7,9,1
12,10,15,1
13,7,9,1
13,10,15,1