11 11 13 3
7,9,15,1
8,9,15,1
9,9,16,1
10,8,14,1
10,15,16,1
11,8,9,1
11,10,16,1
12,8,13,1
12,14,15,1
13,11,15,1
tele
9,10,8,10
9,12,9,13
13,12,13,11